##############
#............#
#............#
#....######..#
#....#....#..#
#.........#..#
##############