##############
#....~~~~~~..#
#....~~~~~~..#
#....######..#
#....#....#..#
#.........#..#
##############