####################
#....~~~~~~........#
#....~~~~~~........#
#....######~~~~~~~~#
#....#..@.#~~~~~~~~#
#.........#~~~~~~~~#
###########........#
          #.@......#
          #........#
          #~~~~~~~~#
          #~~~~~~~~#
          #~~~~~~~~#
          #~~~~~~~~#
          #~~~~~~~~#
          #~~~~~~~~#
          #~~~~~~~~#
          #~~~~~~~~#
          #~~~~~~~~#
          #~~~~~~~~#
          #~~~~~~~~#
          #........#
          #...@....#
          ##########