##############
#....~~~~~~..#
#....~~~~~~..#
#....######..#
#.@..#....#..#
#.........#..#
##############